,State/UT,District,Population,Male,Female,Literate,Literate_Male,Literate_Female,Households_Rural,Households_Urban,Households,Young_and_Adult,Middle_Aged,Senior_Citizen,Age_Not_Started
0,Jammu and Kashmir,Kupwara,870354,474190,396164,439654,282823,156831,158438,23226,181664,600759,178435,89679,1481
1,Jammu and Kashmir,Badgam,753745,398041,355704,335649,207741,127908,160649,27190,187839,503223,160933,88978,611
2,Laddakh,Leh(Ladakh),133487,78971,54516,93770,62834,30936,36920,17474,54394,70703,41515,21019,250
3,Laddakh,Kargil,140802,77785,63017,86236,56301,29935,40370,7774,48144,87532,35561,17488,221
4,Jammu and Kashmir,Punch,476835,251899,224936,261724,163333,98391,132139,15269,147408,304979,109818,61334,704
5,Jammu and Kashmir,Rajouri,642415,345351,297064,364109,224469,139640,196070,17508,213578,404903,153165,83319,1028
6,Jammu and Kashmir,Kathua,616435,326109,290326,389204,228499,160705,181374,33473,214847,357864,160123,97684,764
7,Jammu and Kashmir,Baramula,1008039,534733,473306,545149,337170,207979,210543,48932,259475,636524,239659,130513,1343
8,Jammu and Kashmir,Bandipore,392232,207680,184552,185979,117058,68921,80521,17555,98076,252378,90465,48802,587
9,Jammu and Kashmir,Srinagar,1236829,651124,585705,748584,431746,316838,4518,257721,262239,693238,351561,190330,1700
10,Jammu and Kashmir,Ganderbal,297446,158720,138726,143276,90581,52695,63788,13558,77346,194165,66945,35911,425
11,Jammu and Kashmir,Pulwama,560440,293064,267376,293958,178326,115632,147520,21703,169223,342601,0,0,696
12,Jammu and Kashmir,Shupiyan,266215,136480,129735,136500,80355,56145,75616,5272,80888,170086,60752,35158,219
13,Jammu and Kashmir,Anantnag,1078692,559767,518925,545532,324417,221115,207067,70666,277733,704145,239988,133519,1040
14,Jammu and Kashmir,Kulgam,424483,217620,206863,209085,125052,84033,95952,25178,121130,266858,99870,57253,502
15,Jammu and Kashmir,Doda,409936,213641,196295,219083,138620,80463,122267,11350,133617,263576,93189,52744,427
16,Jammu and Kashmir,Ramban,283713,149132,134581,124065,82938,41127,84281,5341,89622,188526,61604,33220,363
17,Jammu and Kashmir,Kishtwar,230696,120165,110531,107506,68700,38806,72378,5993,78371,145931,53415,31084,266
18,Jammu and Kashmir,Udhampur,554985,296784,258201,322354,197543,124811,148664,34696,183360,339145,140785,74757,298
19,Jammu and Kashmir,Reasi,314667,166461,148206,150542,93937,56605,95572,12261,107833,203967,70767,39743,190
20,Jammu and Kashmir,Jammu,1529958,813821,716137,1137135,641916,495219,254566,248043,502609,816827,435895,275585,1651
21,Jammu and Kashmir,Samba,318898,169124,149774,228139,130312,97827,94247,19989,114236,177277,88246,53022,353
22,Himachal Pradesh,Chamba,519080,261320,257760,323842,186064,137778,186395,13836,200231,306555,130606,81566,353
23,Himachal Pradesh,Kangra,1510075,750591,759484,1152640,606443,546197,588321,39007,627328,766581,419172,319420,4902
24,Himachal Pradesh,Lahul and Spiti,31564,16588,14976,21845,12897,8948,17434,0,17434,15928,9181,6200,255
25,Himachal Pradesh,Kullu,437903,225452,212451,307672,174550,133122,167995,20709,188704,244727,120510,72282,384
26,Himachal Pradesh,Mandi,999777,498065,501712,723747,393669,330078,431129,31696,462825,524285,279321,194661,1510
27,Himachal Pradesh,Hamirpur,454768,217070,237698,358091,180555,177536,196116,15232,211348,224044,123941,106641,142
28,Himachal Pradesh,Una,521173,263692,257481,399715,213281,186434,185091,20126,205217,273223,142351,105358,241
29,Himachal Pradesh,Bilaspur,381956,192764,189192,287620,155599,132021,152458,11987,164445,193671,107367,80497,421
30,Himachal Pradesh,Solan,580320,308754,271566,428578,244372,184206,192787,51509,244296,321533,167168,90808,811
31,Himachal Pradesh,Sirmaur,529855,276289,253566,362645,205617,157028,171102,21054,192156,0,0,82471,301
32,Himachal Pradesh,Shimla,814010,425039,388971,612642,342846,269796,279269,95896,375165,425721,241956,145577,756
33,Himachal Pradesh,Kinnaur,84121,46249,37872,60699,36697,24002,44514,0,44514,42360,26599,15075,87
34,Punjab,Gurdaspur,2298323,1212617,1085706,1634719,907660,727059,420860,185488,606348,1261421,611353,423301,2248
35,Punjab,Kapurthala,815168,426311,388857,576567,316254,260313,165433,95770,261203,433331,222324,157833,1680
36,Punjab,Jalandhar,2193590,1145211,1048379,1622537,882581,739956,330339,377791,708130,1159156,616431,416449,1554
37,Punjab,Hoshiarpur,1586625,809057,777568,1199699,637927,561772,422673,128592,551265,831741,422782,330671,1431
38,Punjab,Shahid Bhagat Singh Nagar,612310,313291,299019,438459,239155,199304,183168,48383,231551,318597,163305,128310,2098
39,Punjab,Fatehgarh Sahib,600163,320795,279368,426033,238696,187337,117559,57337,174896,321018,166781,111028,1336
40,Punjab,Ludhiana,3498739,1867816,1630923,2560225,1428348,1131877,395032,641789,1036821,1901528,980046,614258,2907
41,Punjab,Moga,995746,525920,469826,627889,348549,279340,214295,74144,288439,535408,258826,194768,6744
42,Punjab,Firozpur,2029074,1071637,957437,1227511,707070,520441,348522,153868,502390,1171770,525459,331259,586
43,Punjab,Muktsar,901896,475622,426274,524848,300401,224447,149507,74650,224157,495167,242628,162297,1804
44,Punjab,Faridkot,617508,326671,290837,381285,215767,165518,99946,58917,158863,336540,164962,113721,2285
45,Punjab,Bathinda,1388525,743197,645328,844868,488261,356607,218159,137563,355722,754927,377707,255283,608
46,Punjab,Mansa,769751,408732,361019,423560,244037,179523,145603,50786,196389,420050,200882,146103,2716
47,Punjab,Patiala,1895686,1002522,893164,1266791,711052,555739,299279,218090,517369,1042519,517079,335100,988
48,Punjab,Amritsar,2490656,1318408,1172248,1684770,932981,751789,275477,385476,660953,1384987,667193,436496,1980
49,Punjab,Tarn Taran,1119627,589369,530258,666162,376427,289735,222717,44457,267174,641875,283645,190898,3209
50,Punjab,Rupnagar,684627,357485,327142,502731,278534,224197,148162,60537,208699,365300,185424,131707,2196
51,Punjab,Sahibzada Ajit Singh Nagar,994628,529253,465375,736575,409944,326631,117293,174042,291335,540872,281462,171656,638
52,Punjab,Sangrur,1655169,878029,777140,1002077,570413,431664,292156,156788,448944,904316,435148,311621,4084
53,Punjab,Barnala,595527,317522,278005,359831,201999,157832,102577,54222,156799,322607,158413,114077,430
54,Chandigarh,Chandigarh,1055450,580663,474787,805438,465346,340092,8911,289456,298367,602411,303748,148945,346
55,Uttarakhand,Uttarkashi,330086,168597,161489,215126,128237,86889,112148,9061,121209,202426,75997,51245,418
56,Uttarakhand,Chamoli,391605,193991,197614,280556,155395,125161,163434,22906,186340,229715,93182,67873,835
57,Uttarakhand,Rudraprayag,242285,114589,127696,170933,91803,79130,112705,4454,117159,141848,54979,44986,472
58,Uttarakhand,Tehri Garhwal,618931,297986,320945,407994,227406,180588,227059,27177,254236,368324,139371,109998,1238
59,Uttarakhand,Dehradun,1696694,892199,804495,1259506,702216,557290,228245,269393,497638,968517,446046,276280,5851
60,Uttarakhand,Garhwal,687271,326829,360442,494889,262148,232741,279682,36780,316462,380765,160183,145445,878
61,Uttarakhand,Pithoragarh,483439,239306,244133,345550,189623,155927,183687,26256,209943,273494,116749,92517,679
62,Uttarakhand,Bageshwar,259898,124326,135572,179483,97546,81937,96031,3880,99911,147488,60569,51672,169
63,Uttarakhand,Almora,622506,291081,331425,436497,231604,204893,260056,21082,281138,351595,141238,128994,679
64,Uttarakhand,Champawat,259648,131125,128523,177726,102015,75711,85202,12839,98041,156916,60722,41913,97
65,Uttarakhand,Nainital,954605,493666,460939,696500,385779,310721,193086,105577,298663,562548,243095,147053,1909
66,Uttarakhand,Udham Singh Nagar,1648902,858783,790119,1037839,598525,439314,269406,145253,414659,1042614,392370,212223,1695
67,Uttarakhand,Hardwar,1890422,1005295,885127,1178354,691411,486943,301828,186183,488011,1207120,435385,246229,1688
68,Haryana,Panchkula,561293,299679,261614,405318,229862,175456,70895,93656,164551,309078,157076,93606,1533
69,Haryana,Ambala,1128350,598703,529647,818025,461288,356737,175365,139891,315256,617859,308126,201685,680
70,Haryana,Yamunanagar,1214205,646718,567487,832457,474793,357664,214464,143259,357723,0,317708,0,298
71,Haryana,Kurukshetra,964655,510976,453679,646893,370828,276065,203553,88268,291821,552034,250830,160216,1575
72,Haryana,Kaithal,1074304,571003,503301,646529,385782,260747,231091,75696,306787,630194,265813,176320,1977
73,Haryana,Karnal,1505324,797712,707612,978013,564516,413497,292682,135920,428602,884972,380409,234684,5259
74,Haryana,Panipat,1205437,646857,558580,786599,464136,322463,173502,153804,327306,739075,298764,167244,354
75,Haryana,Sonipat,1450001,781299,668702,998316,589881,408435,283858,133576,417434,855201,360216,233318,1266
76,Haryana,Jind,1334152,713006,621146,832758,502049,330709,278335,89665,368000,784085,335704,213478,885
77,Haryana,Fatehabad,942011,495360,446651,557578,327471,230107,203020,55360,258380,555745,237009,147469,1788
78,Haryana,Sirsa,1295189,682582,612607,782897,456968,325929,245476,93316,338792,750228,334344,208185,2432
79,Haryana,Hisar,1743931,931562,812369,1114311,670200,444111,302013,154113,456126,1017830,456536,265109,4456
80,Haryana,Bhiwani,1634445,866672,767773,1069871,643158,426713,357047,99235,456282,964960,405760,261428,2297
81,Haryana,Rohtak,1061204,568479,492725,747582,436025,311557,175203,131739,306942,605741,269354,185685,424
82,Haryana,Jhajjar,958405,514667,443738,676091,399480,276611,211816,78328,290144,549975,245095,162356,979
83,Haryana,Mahendragarh,922088,486665,435423,630255,380440,249815,223726,44216,267942,530000,229392,161258,1438
84,Haryana,Rewari,900332,474335,425997,636947,375453,261494,199449,69305,268754,518747,230704,150557,324
85,Haryana,Gurgaon,1514432,816690,697742,1111116,638666,472450,141703,381988,523691,875531,428101,210307,493
86,Haryana,Mewat,1089263,571162,518101,454897,308435,146462,187398,36237,223635,790930,186916,110688,729
87,Haryana,Faridabad,1809733,966110,843623,1272739,734940,537799,87700,382981,470681,1095602,481318,231029,1784
88,Haryana,Palwal,1042708,554497,488211,599796,379696,220100,186069,63090,249159,684189,224043,133913,563
89,Nct Of Delhi,North West,3656539,1960922,1695617,2707855,1541952,1165903,67592,959275,1026867,2138591,1013424,503055,1469
90,Nct Of Delhi,North,887978,475002,412976,681517,381615,299902,4512,296559,301071,506601,256501,124513,363
91,Nct Of Delhi,North East,2241624,1188425,1053199,1611588,912481,699107,5326,482255,487581,1393078,581016,264663,2867
92,Nct Of Delhi,East,1709346,907500,801846,1352998,748382,604616,1086,461132,462218,948963,497157,262124,1102
93,Nct Of Delhi,New Delhi,142004,77942,64062,114179,65678,48501,0,52664,52664,76076,43913,21773,242
94,Nct Of Delhi,Central,582320,307821,274499,442360,240518,201842,0,194897,194897,317650,169533,94448,689
95,Nct Of Delhi,West,2543243,1356240,1187003,1961179,1093933,867246,1809,699703,701512,1399165,732515,408953,2610
96,Nct Of Delhi,South West,2292958,1246046,1046912,1787689,1025261,762428,41179,606503,647682,1296955,683209,308675,4119
97,Nct Of Delhi,South,2731929,1467428,1264501,2078402,1185036,893366,2918,728145,731063,1588001,785085,355602,3241
98,Rajasthan,Ganganagar,1969168,1043340,925828,1193343,710908,482435,397697,164897,562594,1167889,502211,283484,15584
99,Rajasthan,Hanumangarh,1774692,931184,843508,1034136,624281,409855,389059,108694,497753,1058044,453114,242361,21173
100,Rajasthan,Bikaner,2363937,1240801,1123136,1278801,782399,496402,335754,196179,531933,1543867,517271,288165,14634
101,Rajasthan,Churu,2039547,1051446,988101,1149269,696729,452540,344897,148996,493893,1293193,458725,272176,15453
102,Rajasthan,Jhunjhunun,2137045,1095896,1041149,1370360,815834,554526,500452,150357,650809,1298780,494124,330126,14015
103,Rajasthan,Alwar,3674179,1939026,1735153,2182476,1359829,822647,782294,212967,995261,2346721,836000,490137,1321
104,Rajasthan,Bharatpur,2548462,1355726,1192736,1480869,943910,536959,0,129697,0,1659515,546362,329127,13458
105,Rajasthan,Dhaulpur,1206516,653647,552869,683098,435721,247377,214670,58626,273296,815651,248416,141365,1084
106,Rajasthan,Karauli,1458248,783639,674609,805849,531904,273945,305047,59308,364355,947173,310688,192042,8345
107,Rajasthan,Sawai Madhopur,1335551,704031,631520,741748,486184,255564,282057,71264,353321,841697,309237,183234,1383
108,Rajasthan,Dausa,1634409,857787,776622,938051,596935,341116,361084,59610,420694,1047136,358718,210117,18438
109,Rajasthan,Jaipur,6626178,3468507,3157671,4300965,2554793,1746172,754841,977838,1732679,4091148,1646480,884057,4493
110,Rajasthan,Sikar,2677333,1374990,1302343,1652117,995275,656842,527560,178274,705834,1672813,605002,381226,18292
111,Rajasthan,Nagaur,3307743,1696325,1611418,1758624,1102750,655874,675712,166489,842201,2088323,754143,463469,1808
112,Rajasthan,Jodhpur,3687165,1923928,1763237,2031532,1265753,765779,584215,307442,891657,2359786,836322,489280,1777
113,Rajasthan,Jaisalmer,669919,361708,308211,308653,210415,98238,159117,30830,189947,448969,140294,79977,679
114,Rajasthan,Barmer,2603751,1369022,1234729,1188322,783461,404861,542825,55980,598805,1731122,527629,326476,18524
115,Rajasthan,Jalor,1828730,936634,892096,829582,543923,285659,419216,48202,467418,1176496,390598,249379,12257
116,Rajasthan,Sirohi,1036346,534231,502115,476806,309900,166906,238535,69639,308174,649290,244401,142251,404
117,Rajasthan,Pali,2037573,1025422,1012151,1085693,667381,418312,512909,139808,652717,1207983,467436,343384,18770
118,Rajasthan,Ajmer,2583052,1324085,1258967,1526673,926268,600405,409335,274919,684254,1561077,629951,388040,3984
119,Rajasthan,Tonk,1421326,728136,693190,749659,478329,271330,298911,81755,380666,880194,334006,205593,1533
120,Rajasthan,Bundi,1110906,577160,533746,585044,371705,213339,239836,63452,303288,686771,267648,155958,529
121,Rajasthan,Bhilwara,2408523,1220736,1187787,1256126,777582,478544,530015,145865,675880,1439454,589476,365023,14570
122,Rajasthan,Rajsamand,1156597,581339,575258,619139,383334,235805,304622,61054,365676,687165,275099,193668,665
123,Rajasthan,Dungarpur,1388552,696532,692020,681591,415820,265771,322816,31547,354363,868458,317700,191917,10477
124,Rajasthan,Banswara,1797485,907754,889731,829343,513854,315489,390437,39407,429844,1153029,406214,216554,21688
125,Rajasthan,Chittaurgarh,1544338,783171,761167,821825,514851,306974,366780,88873,455653,880043,398303,258997,6995
126,Rajasthan,Kota,1951014,1021161,929853,1298345,765396,532949,203454,311735,515189,1177474,495896,275396,2248
127,Rajasthan,Baran,1222755,633945,588810,693307,432607,260700,249184,69804,318988,762204,286344,173100,1107
128,Rajasthan,Jhalawar,1411129,725143,685986,739792,466815,272977,298624,63763,362387,850546,346110,213674,799
129,Rajasthan,Udaipur,3068420,1566801,1501619,1582629,973444,609185,665449,182769,848218,1876436,739287,451034,1663
130,Rajasthan,Pratapgarh,867848,437744,430104,401515,250122,151393,209813,24269,234082,545987,204801,115608,1452
131,Uttar Pradesh,Saharanpur,3466382,1834106,1632276,2077108,1220114,856994,605082,284156,889238,2228689,769736,433862,34095
132,Uttar Pradesh,Muzaffarnagar,4143512,2193434,1950078,2417339,1448528,968811,673746,296104,969850,2671757,911621,544283,15851
133,Uttar Pradesh,Bijnor,3682713,1921215,1761498,2135393,1241471,893922,683875,224648,908523,2404576,786305,450186,41646
134,Uttar Pradesh,Moradabad,4772006,2503186,2268820,2263848,1357435,906413,692398,355518,1047916,3168270,988486,525574,89676
135,Uttar Pradesh,Rampur,2335819,1223889,1111930,1043666,630408,413258,396775,143217,539992,1576123,491164,258913,9619
136,Uttar Pradesh,Jyotiba Phule Nagar,1840221,963449,876772,983110,600541,382569,335888,115486,451374,1227283,391275,215849,5814
137,Uttar Pradesh,Meerut,3443689,1825743,1617946,2141488,1254520,886968,381520,422303,803823,2165117,780475,451827,46270
138,Uttar Pradesh,Baghpat,1303048,700070,602978,797970,489858,308112,246055,69991,316046,817140,283276,194548,8084
139,Uttar Pradesh,Ghaziabad,4681645,2488834,2192811,3123264,1811397,1311867,355407,836316,1191723,2891069,1139871,559963,90742
140,Uttar Pradesh,Gautam Buddha Nagar,1648115,890214,757901,1122947,666065,456882,170835,338935,509770,1015648,402967,188862,40638
141,Uttar Pradesh,Bulandshahr,3499171,1845260,1653911,2031656,1253314,778342,658449,221628,880077,2246254,753949,472808,26160
142,Uttar Pradesh,Aligarh,3673889,1951996,1721893,2092567,1283380,809187,582117,275942,858059,2378289,787408,472667,35525
143,Uttar Pradesh,Mahamaya Nagar,1564708,836127,728581,942572,579157,363415,288150,84883,373033,1011157,339137,210083,4331
144,Uttar Pradesh,Mathura,2547184,1367125,1180059,1507746,943346,564400,407488,177802,585290,1600686,535738,327854,82906
145,Uttar Pradesh,Agra,4418797,2364953,2053844,2680510,1614594,1065916,496971,406852,903823,2871903,991255,547873,7766
146,Uttar Pradesh,Firozabad,2498156,1332046,1166110,1521806,912314,609492,349747,185621,535368,1621154,543730,312689,20583
147,Uttar Pradesh,Mainpuri,1868529,993377,875152,1203885,712110,491775,338475,72783,411258,1193660,402321,265638,6910
148,Uttar Pradesh,Budaun,3681896,1967759,1714137,1547477,986501,560976,710956,156668,867624,2436051,748408,424194,73243
149,Uttar Pradesh,Bareilly,4448359,2357665,2090694,2191759,1342697,849062,631613,362798,994411,2893965,952233,514141,88020
150,Uttar Pradesh,Pilibhit,2031007,1072002,959005,1061095,654290,406805,371752,89638,461390,1320476,449673,256276,4582
151,Uttar Pradesh,Shahjahanpur,3006538,1606403,1400135,1490930,915142,575788,520289,134714,655003,1961237,652237,368743,24321
152,Uttar Pradesh,Kheri,4021243,2123187,1898056,2034044,1237157,796887,754938,107672,862610,2582597,896611,510832,31203
153,Uttar Pradesh,Sitapur,4483992,2375264,2108728,2283733,1397702,886031,827583,111319,938902,2862383,1000987,588318,32304
154,Uttar Pradesh,Hardoi,4092845,2191442,1901403,2221601,1374587,847014,786613,121064,907677,2598364,905306,559988,29187
155,Uttar Pradesh,Unnao,3108367,1630087,1478280,1773584,1053063,720521,596317,121039,717356,1893706,706851,453462,54348
156,Uttar Pradesh,Lucknow,4589838,2394476,2195362,3127260,1742440,1384820,344155,717566,1061721,2678289,1161686,685258,64605
157,Uttar Pradesh,Rae Bareli,3405559,1752542,1653017,1965843,1165965,799878,705025,73393,778418,2116007,776583,506583,6386
158,Uttar Pradesh,Farrukhabad,1885204,1006240,878964,1092677,654827,437850,316647,94843,411490,1224584,411153,246795,2672
159,Uttar Pradesh,Kannauj,1656616,881776,774840,1017087,603596,413491,299785,65985,365770,1069916,361028,223535,2137
160,Uttar Pradesh,Etawah,1581810,845856,735954,1062003,623583,438420,265643,85483,351126,979633,362026,237786,2365
161,Uttar Pradesh,Auraiya,1379545,740040,639505,930836,546198,384638,255836,58438,314274,856336,320763,202054,392
162,Uttar Pradesh,Kanpur Dehat,1796184,963255,832929,1170243,692964,477279,363933,41323,405256,1100820,415918,276272,3174
163,Uttar Pradesh,Kanpur Nagar,4581268,2459806,2121462,3243022,1829179,1413843,364869,684906,1049775,2630411,1209554,731795,9508
164,Uttar Pradesh,Jalaun,1689974,906092,783882,1075196,653430,421766,304856,91565,396421,1002817,410090,274954,2113
165,Uttar Pradesh,Jhansi,1998603,1057436,941167,1304513,783705,520808,309592,195321,504913,1171301,510728,308331,8243
166,Uttar Pradesh,Lalitpur,1221592,641011,580581,641191,397586,243605,258013,43819,301832,793551,265080,159666,3295
167,Uttar Pradesh,Hamirpur,1104285,593537,510748,653299,408125,245174,256081,55300,311381,660774,260368,181109,2034
168,Uttar Pradesh,Mahoba,875958,466358,409600,488106,302283,185823,198298,48525,246823,527067,201394,137393,10104
169,Uttar Pradesh,Banda,1799410,965876,833534,1002937,630626,372311,378056,67569,445625,1120432,408527,265310,5141
170,Uttar Pradesh,Chitrakoot,991730,527721,464009,531072,330339,200733,207237,23558,230795,638046,214228,136669,2787
171,Uttar Pradesh,Fatehpur,2632733,1384722,1248011,1512166,911003,601163,558807,77733,636540,1624830,603831,395547,8525
172,Uttar Pradesh,Pratapgarh,3209141,1606085,1603056,1931559,1121381,810178,711085,41701,752786,2002569,703727,492097,10748
173,Uttar Pradesh,Kaushambi,1599596,838485,761111,813424,507279,306145,349856,30764,380620,1034099,336401,210556,18540
174,Uttar Pradesh,Allahabad,5954391,3131807,2822584,3665727,2199340,1466387,983266,265304,1248570,3764404,1335224,818137,36626
175,Uttar Pradesh,Bara Banki,3260699,1707073,1553626,1692458,1010518,681940,635840,79068,714908,2043335,709494,445269,62601
176,Uttar Pradesh,Faizabad,2470996,1259628,1211368,1450901,838339,612562,510378,79288,589666,1534832,543148,367332,25684
177,Uttar Pradesh,Ambedkar Nagar,2397888,1212410,1185478,1486939,846676,640263,501559,65031,566590,1499494,515229,367234,15931
178,Uttar Pradesh,Sultanpur,3797117,1914586,1882531,2239902,1300248,939654,839737,49891,889628,2376875,828222,580164,11856
179,Uttar Pradesh,Bahraich,3487731,1843884,1643847,1398368,878285,520083,698520,61742,760262,2275746,754346,446242,11397
180,Uttar Pradesh,Shrawasti,1117361,593897,523464,423313,276700,146613,248770,8504,257274,723443,245098,143979,4841
181,Uttar Pradesh,Balrampur,2148665,1114721,1033944,868357,544943,323414,410070,35768,445838,1415213,442339,283947,7166
182,Uttar Pradesh,Gonda,3433919,1787146,1646773,1679994,1034181,645813,673578,52794,726372,2223078,734903,464584,11354
183,Uttar Pradesh,Siddharthnagar,2559297,1295095,1264202,1228926,740718,488208,480165,33348,513513,1690396,504002,359977,4922
184,Uttar Pradesh,Basti,2464464,1255272,1209192,1393783,819719,574064,513960,31065,545025,1574037,519265,363891,7271
185,Uttar Pradesh,Sant Kabir Nagar,1715183,869656,845527,954949,567098,387851,324972,27179,352151,1108368,352395,250502,3918
186,Uttar Pradesh,Mahrajganj,2684703,1381754,1302949,1419144,881674,537470,573046,34033,607079,1694493,595114,370573,24523
187,Uttar Pradesh,Gorakhpur,4440895,2277777,2163118,2700328,1593890,1106438,761958,189170,951128,2755630,992114,659677,33474
188,Uttar Pradesh,Kushinagar,3564544,1818055,1746489,1954820,1183722,771098,742324,42775,785099,2236842,772777,500373,54552
189,Uttar Pradesh,Deoria,3100946,1537436,1563510,1875239,1079288,795951,597778,67928,665706,1946336,664708,481219,8683
190,Uttar Pradesh,Azamgarh,4613913,2285004,2328909,2771917,1559414,1212503,891024,80434,971458,2930243,965876,699954,17840
191,Uttar Pradesh,Mau,2205968,1114709,1091259,1363044,773082,589962,352207,99321,451528,1402738,467343,323260,12627
192,Uttar Pradesh,Ballia,3239774,1672902,1566872,1963590,1160960,802630,564927,64454,629381,1975934,724362,502628,36850
193,Uttar Pradesh,Jaunpur,4494204,2220465,2273739,2731677,1565394,1166283,926088,80582,1006670,2826453,927026,689979,50746
194,Uttar Pradesh,Ghazipur,3620268,1855075,1765193,2197549,1293553,903996,700173,61467,761640,2234593,774130,556273,55272
195,Uttar Pradesh,Chandauli,1952756,1017905,934851,1174606,699454,475152,344937,50822,395759,1222695,437000,287767,5294
196,Uttar Pradesh,Varanasi,3676841,1921857,1754984,2403903,1389116,1014787,438935,316129,755064,2260457,856070,531549,28765
197,Uttar Pradesh,Sant Ravidas Nagar (Bhadohi),1578213,807099,771114,910146,546782,363364,293510,45997,339507,1032294,331743,209920,4256
198,Uttar Pradesh,Mirzapur,2496970,1312302,1184668,1428683,865837,562846,465152,77963,543115,1590528,552177,346773,7492
199,Uttar Pradesh,Sonbhadra,1862559,971344,891215,985708,601988,383720,337048,91040,428088,1203938,418914,237866,1841
200,Uttar Pradesh,Etah,1774480,947339,827141,1055202,647042,408160,334246,67752,401998,1149372,383707,237427,3974
201,Uttar Pradesh,Kanshiram Nagar,1436719,764165,672554,724850,452803,272047,271234,72490,343724,946320,301252,183434,5713
202,Bihar,Pashchim Champaran,3935042,2061110,1873932,1759481,1091226,668255,839514,96620,936134,2544205,888205,497793,4839
203,Bihar,Purba Champaran,5099371,2681209,2418162,2276957,1407603,869354,1142260,101565,1243825,3316422,1122340,648009,12600
204,Bihar,Sheohar,656246,346673,309573,283698,171645,112053,158484,7516,166000,421241,139909,93398,1698
205,Bihar,Sitamarhi,3423574,1803252,1620322,1436794,885188,551606,807294,49670,856964,2206340,739982,449035,28217
206,Bihar,Madhubani,4487379,2329313,2158066,2155338,1340085,815253,1047552,41234,1088786,2860455,0,611899,0
207,Bihar,Supaul,2229076,1155283,1073793,1033283,647672,385611,572287,27815,600102,1453438,495020,277610,3008
208,Bihar,Araria,2811569,1463333,1348236,1195768,727643,468125,659061,44213,703274,1872943,612012,324091,2523
209,Bihar,Kishanganj,1690400,866970,823430,745056,439921,305135,401793,43357,445150,1139615,361114,188447,1224
210,Bihar,Purnia,3264619,1699370,1565249,1332326,805261,527065,712847,85749,798596,2155512,696556,372692,39859
211,Bihar,Katihar,3071029,1600430,1470599,1280190,762256,517934,668232,69838,738070,2054202,660403,353483,2941
212,Bihar,Madhepura,2001762,1047559,954203,834577,517666,316911,486278,24000,510278,1311771,444235,242382,3374
213,Bihar,Saharsa,1900661,997174,903487,804996,506374,298622,432651,38046,470697,1249692,415863,233870,1236
214,Bihar,Darbhanga,3937385,2059949,1877436,1816634,1125566,691068,907174,95539,1002713,2535344,865971,529314,6756
215,Bihar,Muzaffarpur,4801062,2527497,2273565,2509232,1487117,1022115,998694,120700,1119394,3016735,1079189,697108,8030
216,Bihar,Gopalganj,2562012,1267666,1294346,1382998,793905,589093,515925,38133,554058,1642807,546202,370662,2341
217,Bihar,Siwan,3330464,1675090,1655374,1930175,1115906,814269,632514,41858,674372,2115448,713597,498299,3120
218,Bihar,Saran,3951862,2022821,1929041,2157454,1285767,871687,701323,76299,777622,2516115,847031,585386,3330
219,Bihar,Vaishali,3495021,1844535,1650486,1926740,1152576,774164,699317,51494,750811,2176701,759132,486032,73156
220,Bihar,Samastipur,4261566,2230003,2031563,2142880,1293575,849305,1012979,43486,1056465,2766930,913339,568812,12485
221,Bihar,Begusarai,2970541,1567660,1402881,1548673,918507,630166,594377,139248,733625,1951688,644874,369996,3983
222,Bihar,Khagaria,1666886,883786,783100,768028,461153,306875,373696,21007,394703,1114645,355531,195796,914
223,Bihar,Bhagalpur,3037766,1615663,1422103,1573066,937669,635397,522527,130634,653161,1952879,674660,397654,12573
224,Bihar,Banka,2034763,1067140,967623,965321,590961,374360,425604,18492,444096,1291235,462080,278863,2585
225,Bihar,Munger,1367765,729041,638724,801817,473741,328076,222281,85782,308063,860147,316713,188319,2586
226,Bihar,Lakhisarai,1000912,526345,474567,507270,305182,202088,175882,31763,207645,650642,218840,130655,775
227,Bihar,Sheikhpura,636342,329743,306599,328676,196431,132245,108293,24345,132638,413475,136898,85045,924
228,Bihar,Nalanda,2877653,1497060,1380593,1519933,919558,600375,514141,102522,616663,1829128,642197,403129,3199
229,Bihar,Patna,5838465,3078512,2759953,3459679,2028047,1431632,657991,552103,1210094,3626564,1382654,815638,13609
230,Bihar,Bhojpur,2728407,1430380,1298027,1599151,973486,625665,434559,77368,511927,1722387,613072,387389,5559
231,Bihar,Buxar,1706352,887977,818375,989807,593544,396263,299252,35405,334657,1074754,375372,253998,2228
232,Bihar,Kaimur (Bhabua),1626384,847006,779378,920276,549923,370353,325143,15299,340442,1039302,353413,226808,6861
233,Bihar,Rohtas,2959918,1543546,1416372,1799832,1061783,738049,512383,95678,608061,1875174,673742,407193,3809
234,Bihar,Aurangabad,2540073,1318684,1221389,1466002,868733,597269,428291,49006,477297,1626969,564571,340948,7585
235,Bihar,Gaya,4391418,2266566,2124852,2297613,1368803,928810,696289,111282,807571,2810026,936630,537333,107429
236,Bihar,Nawada,2219146,1144668,1074478,1091012,659474,431538,379551,45323,424874,1440781,485628,288805,3932
237,Bihar,Jamui,1760405,916064,844341,858588,534385,324203,325909,30851,356760,1135919,392052,227016,5418
238,Bihar,Jehanabad,1125313,585582,539731,618881,374412,244469,186660,28132,214792,714244,254582,155106,1381
239,Bihar,Arwal,700843,363497,337346,386351,235279,151072,134334,9960,144294,444448,156031,98550,1814
240,Sikkim,North  District,43709,24730,18979,30450,18579,11871,11543,2066,13609,27099,11674,4887,49
241,Sikkim,West District,136435,70238,66197,93432,51988,41444,32091,1886,33977,84209,32520,19400,306
242,Sikkim,South District,146850,76670,70180,106741,59357,47384,31135,8163,39298,87982,37318,20982,568
243,Sikkim,East District,283583,151432,132151,214329,121345,92984,40626,41512,82138,165520,80354,37456,253
244,Arunachal Pradesh,Tawang,49977,29151,20826,26073,17720,8353,10730,2452,13182,30709,13849,5399,20
245,Arunachal Pradesh,West Kameng,83947,46155,37792,48492,29566,18926,17889,0,0,53026,22362,8493,66
246,Arunachal Pradesh,East Kameng,78690,38775,39915,38449,21599,16850,14503,5215,19718,53752,17922,6960,56
247,Arunachal Pradesh,Papum Pare,176573,89182,87391,121048,65794,55254,20308,30180,50488,120592,43812,11856,313
248,Arunachal Pradesh,Upper Subansiri,83448,41758,41690,45278,24807,20471,14542,4672,19214,56054,20055,7230,109
249,Arunachal Pradesh,West Siang,112274,58168,54106,64746,36777,27969,22272,8503,30775,70415,28305,13469,85
250,Arunachal Pradesh,East Siang,99214,50116,49098,62576,34210,28366,19497,9524,29021,61993,25334,11802,85
251,Arunachal Pradesh,Upper Siang,35320,18699,16621,18195,10723,7472,8569,2182,10751,21090,8910,5252,68
252,Arunachal Pradesh,Changlang,148226,76948,71278,73174,44027,29147,33422,6498,39920,96630,35018,16414,164
253,Arunachal Pradesh,Tirap,111975,57604,54371,47974,29313,18661,18420,6500,24920,71785,25669,14423,98
254,Arunachal Pradesh,Lower Subansiri,83030,41843,41187,54057,29470,24587,18112,5365,23477,55258,20305,7412,55
255,Arunachal Pradesh,Kurung Kumey,92076,45318,46758,36606,20258,16348,18603,1092,19695,64379,20713,6836,148
256,Arunachal Pradesh,Dibang Valley,8004,4414,3590,4436,2614,1822,2055,1175,3230,5113,2088,786,17
257,Arunachal Pradesh,Lower Dibang Valley,54080,28053,26027,31849,18087,13762,12000,3950,15950,35140,13254,5652,34
258,Arunachal Pradesh,Lohit,145726,76221,69505,83062,48380,34682,33599,11372,44971,94890,35493,15195,148
259,Arunachal Pradesh,Anjaw,21167,11507,9660,9990,6523,3467,6025,428,6453,13913,4755,2456,43
260,Nagaland,Mon,250260,131753,118507,119626,67432,52194,43607,7415,51022,168773,53600,27437,450
261,Nagaland,Mokokchung,194622,101092,93530,159494,83479,76015,37536,17742,55278,111243,52853,30363,163
262,Nagaland,Zunheboto,140757,71217,69540,102881,53504,49377,31267,6044,37311,91709,32267,16730,51
263,Nagaland,Wokha,166343,84505,81838,128208,67385,60823,38499,8170,46669,106951,40510,18811,71
264,Nagaland,Dimapur,378811,197394,181417,278037,150142,127895,49116,62853,111969,243392,98601,36618,200
265,Nagaland,Phek,163418,83743,79675,105893,57926,47967,38903,7295,46198,108514,37842,16969,93
266,Nagaland,Tuensang,196596,101933,94663,117511,63653,53858,40690,9451,50141,134573,43210,18762,51
267,Nagaland,Longleng,50484,26502,23982,29859,16139,13720,12686,2451,15137,33970,11210,5271,33
268,Nagaland,Kiphire,74004,37830,36174,41232,22675,18557,16032,4290,20322,52699,14955,6309,41
269,Nagaland,Kohima,267988,138966,129022,197489,107038,90451,31845,44255,76100,173701,68485,25557,245
270,Nagaland,Peren,95219,49714,45505,62204,34584,27620,20204,4073,24277,64393,21597,9156,73
271,Manipur,Senapati,479148,247323,231825,264477,148012,116465,38008,1826,39834,314439,111516,52008,1185
272,Manipur,Tamenglong,140651,72371,68280,85006,47403,37603,23982,4119,28101,90273,33290,16924,164
273,Manipur,Churachandpur,274143,138820,135323,195935,104013,91922,52972,4853,57825,168608,67802,37096,637
274,Manipur,Bishnupur,237399,118782,118617,156333,87313,69020,34977,21172,56149,135220,62907,38815,457
275,Manipur,Thoubal,422168,210845,211323,269304,152617,116687,65961,38302,104263,251975,107196,62060,937
276,Manipur,Imphal West,517992,255054,262938,392626,205985,186641,51055,85746,136801,278940,148146,89394,1512
277,Manipur,Imphal East,456113,226094,230019,324664,173314,151350,64421,46520,110941,261530,123439,70005,1139
278,Manipur,Ukhrul,183998,94718,89280,129829,70148,59681,36084,5806,41890,113715,43646,25165,1472
279,Manipur,Chandel,144182,74579,69603,90302,51053,39249,30377,3783,34160,86255,39324,18329,274
280,Mizoram,Mamit,86364,44828,41536,60191,32977,27214,16726,4129,20855,55914,20082,10318,50
281,Mizoram,Kolasib,83955,42918,41037,65895,34147,31748,9669,12507,22176,52147,20576,11167,65
282,Mizoram,Aizawl,400309,199270,201039,340595,169547,171048,20570,80341,100911,235892,108094,56092,231
283,Mizoram,Champhai,125745,63388,62357,100802,51440,49362,18395,12717,31112,78778,29690,17189,88
284,Mizoram,Serchhip,64937,32851,32086,54476,27598,26878,7472,8018,15490,39568,15894,9404,71
285,Mizoram,Lunglei,161428,82891,78537,121122,64515,56607,21479,17315,38794,100250,39690,21424,64
286,Mizoram,Lawngtlai,117894,60599,57295,62861,36444,26417,21993,5273,27266,80723,25303,11831,37
287,Mizoram,Saiha,56574,28594,27980,42233,21861,20372,7043,5784,12827,37127,12784,6636,27
288,Tripura,West Tripura,1725739,879428,846311,1361354,722998,638356,289621,217016,506637,940424,499719,284637,959
289,Tripura,South Tripura,876001,447544,428457,646810,351082,295728,219171,44906,264077,505558,236676,133424,343
290,Tripura,Dhalai,378230,194544,183686,276217,151643,124574,89457,14071,103528,232286,95548,50269,127
291,Tripura,North Tripura,693947,352860,341087,520402,275646,244756,150437,42184,192621,414878,178608,100274,187
292,Meghalaya,West Garo Hills,643291,324159,319132,358702,193438,165264,139351,18594,157945,427629,143604,70599,1459
293,Meghalaya,East Garo Hills,317917,161223,156694,192147,102513,89634,62698,11518,74216,216742,70424,29926,825
294,Meghalaya,South Garo Hills,142334,73170,69164,82062,45003,37059,35930,3713,39643,97082,30605,14495,152
295,Meghalaya,West Khasi Hills,383461,193715,189746,230678,117307,113371,74832,12299,87131,278569,69988,33431,1473
296,Meghalaya,Ribhoi,258840,132531,126309,155859,80977,74882,57988,5736,63724,183343,52945,22365,187
297,Meghalaya,East Khasi Hills,825922,410749,415173,578030,287270,290760,106248,108843,215091,545961,192428,86576,957
298,Meghalaya,Jaintia Hills,395124,196285,198839,187527,87371,100156,76546,7171,83717,291097,72934,30362,731
299,Assam,Kokrajhar,887142,452905,434237,489305,275220,214085,204896,17115,222011,552671,224715,108956,800
300,Assam,Dhubri,1949258,997848,951410,922341,511551,410790,460602,60417,521019,1286592,439375,221745,1546
301,Assam,Goalpara,1008183,513292,494891,563577,304302,259275,228610,39504,268114,650509,239831,117427,416
302,Assam,Barpeta,1693622,867004,826618,897058,499038,398020,447189,52192,499381,1072312,405046,215355,909
303,Assam,Morigaon,957423,486651,470772,539902,289698,250204,232206,25275,257481,612737,225224,118271,1191
304,Assam,Nagaon,2823768,1439112,1384656,1710716,921850,788866,674999,124186,799185,1778277,678034,366112,1345
305,Assam,Sonitpur,1924110,983904,940206,1108572,620525,488047,483325,64528,547853,1159991,501239,261648,1232
306,Assam,Lakhimpur,1042137,529674,512463,683486,375552,307934,293239,34694,327933,639385,268872,133615,265
307,Assam,Dhemaji,686133,351249,334884,423028,237761,185267,211758,16504,228262,434221,169630,82051,231
308,Assam,Tinsukia,1327929,680231,647698,798322,453449,344873,290704,90910,381614,799874,352158,175377,520
309,Assam,Dibrugarh,1326335,676434,649901,884531,491361,393170,299852,77163,377015,767147,371864,186774,550
310,Assam,Sivasagar,1151050,589216,561834,813505,444767,368738,360182,45047,405229,648056,330947,171710,337
311,Assam,Jorhat,1092256,556805,535451,794929,432335,362594,286330,80824,367154,604908,315550,171062,736
312,Assam,Golaghat,1066888,543161,523727,721764,396475,325289,292893,34190,327083,629153,289085,148244,406
313,Assam,Karbi Anglong,956313,490167,466146,557214,314253,242961,215691,37185,252876,618633,233739,103123,818
314,Assam,Dima Hasao,214102,110802,103300,140873,78559,62314,37610,21309,58919,135463,53699,24830,110
315,Assam,Cachar,1736617,886284,850333,1174128,639946,534182,346227,88933,435160,1048990,444899,241776,952
316,Assam,Karimganj,1228686,625864,602822,795297,435942,359355,261945,32695,294640,779850,284368,163990,478
317,Assam,Hailakandi,659296,337890,321406,407366,226836,180530,159215,16202,175417,419921,156243,82841,291
318,Assam,Bongaigaon,738804,375818,362986,434078,237114,196964,181923,38470,220393,458796,184849,94939,220
319,Assam,Chirang,482162,244860,237302,259902,145869,114033,129018,11613,140631,301518,122244,58282,118
320,Assam,Kamrup,1517542,778461,739081,995319,550219,445100,390596,43849,434445,895775,408232,212740,795
321,Assam,Kamrup Metropolitan,1253938,647585,606353,1001191,537227,463964,61334,366858,428192,659453,401500,190908,2077
322,Assam,Nalbari,771639,396006,375633,531771,293184,238587,210706,28238,238944,442061,211320,117809,449
323,Assam,Baksa,950075,481330,468745,572837,322614,250223,291641,3580,295221,563089,256282,130083,621
324,Assam,Darrang,928500,475273,453227,487039,268666,218373,268517,20189,288706,583436,226525,118102,437
325,Assam,Udalguri,831668,421617,410051,469926,264326,205600,267790,13835,281625,499214,221518,109962,974
326,West Bengal,Darjiling,1846823,937259,909564,1315585,717673,597912,303284,215675,518959,1031221,523288,289979,2335
327,West Bengal,Jalpaiguri,3872846,1983064,1889782,2498780,1396622,1102158,798378,319426,1117804,2259507,1035449,575667,2223
328,West Bengal,Koch Bihar,2819086,1451542,1367544,1850504,1028733,821771,803407,97331,900738,1623320,744646,448761,2359
329,West Bengal,Uttar Dinajpur,3007134,1551066,1456068,0,853495,0,683981,94269,778250,1916033,704859,385155,1087
330,West Bengal,Dakshin Dinajpur,1676276,857199,819077,1083685,596474,487211,390949,70077,461026,937283,465982,271423,1588
331,West Bengal,Maldah,3988845,2051541,1937304,2086432,1152019,934413,830318,128678,958996,2511004,955283,520122,2436
332,West Bengal,Murshidabad,7103807,3627564,3476243,4055834,2177187,1878647,1501066,350899,1851965,4390564,1717594,991413,4236
333,West Bengal,Birbhum,3502404,1790920,1711484,2158447,1201481,956966,831044,134565,965609,2008655,952059,539463,2227
334,West Bengal,Barddhaman,7717563,3966889,3750674,5247208,2918040,2329168,1364868,862368,2227236,4149420,2265543,1292913,9687
335,West Bengal,Nadia,5167600,2653768,2513832,3480555,1878866,1601689,1081381,468390,1549771,2745828,1484986,934417,2369
336,West Bengal,North Twenty Four Parganas,10009781,5119389,4890392,7608693,4056046,3552647,1209337,1649803,2859140,5104876,2968996,1921143,14766
337,West Bengal,Hugli,5519145,2814653,2704492,4078388,2211777,1866611,992085,647953,1640038,2766489,1688206,1060821,3629
338,West Bengal,Bankura,3596674,1838095,1758579,2232992,1299337,933655,900515,90885,991400,1942335,1014764,637834,1741
339,West Bengal,Puruliya,2930115,1496996,1433119,1624905,1002058,622847,653219,99433,752652,1678057,764776,484166,3116
340,West Bengal,Haora,4850029,2500819,2349210,3605206,1942824,1662382,483384,869313,1352697,2587164,1423304,833104,6457
341,West Bengal,Kolkata,4496694,2356766,2139928,3588137,1926915,1661222,0,1308106,1308106,2025389,1433314,1014769,23222
342,West Bengal,South Twenty Four Parganas,8161961,4173778,3988183,5531657,3043277,2488380,1568802,611430,2180232,4763943,2151474,1235558,10986
343,West Bengal,Paschim Medinipur,5913457,3007885,2905572,4078412,2266913,1811499,1364335,201048,1565383,3243971,1664250,990179,15057
344,West Bengal,Purba Medinipur,5095875,2629834,2466041,3923194,2149073,1774121,1193006,170707,1363713,2866678,1384242,842025,2930
345,Jharkhand,Garhwa,1322784,683575,639209,653476,405161,248315,272872,19180,292052,860869,284036,177599,280
346,Jharkhand,Chatra,1042886,533935,508951,510061,303902,206159,200974,14528,215502,692650,222892,126682,662
347,Jharkhand,Kodarma,716259,367222,349037,390249,238780,151469,116714,34771,151485,462098,158603,95309,249
348,Jharkhand,Giridih,2445474,1258098,1187376,1253475,783736,469739,452564,46886,499450,1597269,533788,312967,1450
349,Jharkhand,Deoghar,1492073,775022,717051,793538,0,0,257373,64337,321710,944961,338413,205514,3185
350,Jharkhand,Godda,1313551,677927,635624,604519,376212,228307,276454,15576,292030,820367,308639,183519,1026
351,Jharkhand,Sahibganj,1150567,589391,561176,483263,287303,195960,223450,37543,260993,745027,261849,137727,5964
352,Jharkhand,Pakur,900422,452661,447761,352881,206989,145892,200588,16587,217175,587976,206826,104418,1202
353,Jharkhand,Dhanbad,2684487,1405956,1278531,1722204,1014950,707254,258764,405455,664219,1634835,648876,356445,44331
354,Jharkhand,Bokaro,2062330,1072807,989523,1273520,759088,514432,250312,258452,508764,1261238,510375,282115,8602
355,Jharkhand,Lohardaga,461790,232629,229161,259707,149568,110139,96759,14725,111484,298844,100340,62244,362
356,Jharkhand,Purbi Singhbhum,2293919,1176902,1117017,1507699,856526,651173,262537,342126,604663,1292595,632314,368148,862
357,Jharkhand,Palamu,1939869,1006302,933567,1024563,621706,402857,355529,52375,407904,1244572,425668,268387,1242
358,Jharkhand,Latehar,726978,369666,357312,350682,209706,140976,146377,14137,160514,484084,152720,89870,304
359,Jharkhand,Hazaribagh,1734495,890881,843614,1013249,596113,417136,312983,68765,381748,1107452,396466,230033,544
360,Jharkhand,Ramgarh,949443,494230,455213,596497,350031,246466,134067,118558,252625,594747,230525,123794,377
361,Jharkhand,Dumka,1321442,668514,652928,672409,406275,266134,303697,23281,326978,799323,324226,196164,1729
362,Jharkhand,Jamtara,791042,404830,386212,426312,258260,168052,165555,20113,185668,480895,189889,0,0
363,Jharkhand,Ranchi,2914253,1494937,1419316,1911433,1085244,826189,420740,310242,730982,1742293,725938,409166,36856
364,Jharkhand,Khunti,531885,266335,265550,284575,164741,119834,0,0,135719,327152,125649,78736,348
365,Jharkhand,Gumla,1025213,514390,510823,559720,321795,237925,216629,16445,233074,643579,225871,155452,311
366,Jharkhand,Simdega,599578,300309,299269,343483,191991,151492,144169,11114,155283,357859,143560,97817,342
367,Jharkhand,Pashchimi Singhbhum,1502338,749385,752953,727561,439273,288288,336928,63396,400324,960987,353305,187635,411
368,Jharkhand,Saraikela-Kharsawan,1065056,544411,520645,612993,365332,247661,217248,68439,285687,634975,265892,161542,2647
369,Orissa,Bargarh,1481255,749161,732094,983783,557217,426566,411566,47395,458961,787033,410005,282422,1795
370,Orissa,Jharsuguda,579505,296690,282815,405879,228092,177787,103224,73962,177186,320156,159477,98555,1317
371,Orissa,Sambalpur,1041099,526877,514222,703691,393192,310499,220697,94798,315495,565700,286575,186726,2098
372,Orissa,Debagarh,312520,158230,154290,197819,112649,85170,91408,7350,98758,176062,81789,53989,680
373,Orissa,Sundargarh,2093437,1061147,1032290,1342322,750147,592175,387911,230151,618062,1188918,573238,324436,6845
374,Orissa,Kendujhar,1801733,906487,895246,1052518,605119,447399,490634,83664,574298,1038890,472908,282751,7184
375,Orissa,Mayurbhanj,2519738,1256213,1263525,1369397,794171,575226,689110,64479,753589,1449729,650135,414076,5798
376,Orissa,Baleshwar,2320529,1185787,1134742,1621232,902359,718873,601154,82440,683594,1303828,622575,390611,3515
377,Orissa,Bhadrak,1506337,760260,746077,1094140,596269,497871,373862,54244,428106,848660,393629,260486,3562
378,Orissa,Kendrapara,1440361,717814,722547,1089265,579970,509295,414749,23494,438243,771284,374559,290894,3624
379,Orissa,Jagatsinghapur,1136971,577865,559106,889027,481049,407978,309685,43047,352732,577896,317148,238753,3174
380,Orissa,Cuttack,2624470,1352760,1271710,2011469,1103033,908436,579529,210768,790297,1372301,743090,499895,9184
381,Orissa,Jajapur,1827192,926034,901158,1290455,706396,584059,495611,45528,541139,1010147,479392,332706,4947
382,Orissa,Dhenkanal,1192811,612593,580218,829910,464093,365817,315390,36979,352369,641697,326233,222398,2483
383,Orissa,Anugul,1273821,655718,618103,869456,494425,375031,340410,74177,414587,708493,347521,213517,4290
384,Orissa,Nayagarh,962789,502636,460153,688362,392333,296029,261646,26688,288334,502136,262086,196994,1573
385,Orissa,Khordha,2251673,1167137,1084536,1749936,957515,792421,331834,356895,688729,1199521,653346,391701,7105
386,Orissa,Puri,1698730,865380,833350,1291939,704857,587082,402014,72210,474224,888134,477430,328666,4500
387,Orissa,Ganjam,3529031,1779218,1749813,2210050,1262652,947398,795476,219918,1015394,1980232,924756,613249,10794
388,Orissa,Gajapati,577817,282882,294935,262537,153663,108874,152095,23050,175145,345387,144043,85072,3315
389,Orissa,Kandhamal,733110,359945,373165,399786,233900,165886,218446,24489,242935,436625,177471,117777,1237
390,Orissa,Baudh,441162,221625,219537,271612,158648,112964,131377,6577,137954,253467,111571,75046,1078
391,Orissa,Subarnapur,610183,311312,298871,398421,230393,168028,176927,16575,193502,341561,153760,113450,1412
392,Orissa,Balangir,1648997,830097,818900,927260,545672,381588,476770,62192,538962,904026,430011,310876,4084
393,Orissa,Nuapada,610382,301962,308420,299383,180903,118480,197258,11869,209127,344075,152681,112325,1301
394,Orissa,Kalahandi,1576869,787101,789768,802036,484177,317859,456336,38412,494748,880160,415778,275533,5398
395,Orissa,Rayagada,967911,471960,495951,407735,241959,165776,237343,49205,286548,577569,245766,140825,3751
396,Orissa,Nabarangapur,1220946,604812,616134,470379,286984,183395,342840,29424,372264,745206,297552,171761,6427
397,Orissa,Koraput,1379647,678809,700838,568090,340843,227247,381789,78339,460128,818578,348803,207206,5060
398,Orissa,Malkangiri,613192,303624,309568,244706,147001,97705,167884,15839,183723,381913,146355,83284,1640
399,Chhattisgarh,Koriya,658917,334737,324180,397823,229923,167900,121852,59763,181615,399581,165022,94073,241
400,Chhattisgarh,Surguja,2359886,1193129,1166757,1187941,694686,493255,0,65167,0,1441436,561915,355077,1458
401,Chhattisgarh,Jashpur,851669,424747,426922,495415,280656,214759,0,20722,0,488965,214455,148100,149
402,Chhattisgarh,Raigarh,1493984,750278,743706,951639,542756,408883,354278,66638,420916,841958,398257,253488,281
403,Chhattisgarh,Korba,1206640,612915,593725,748759,433391,315368,206598,126055,332653,729708,309479,166959,494
404,Chhattisgarh,Janjgir - Champa,1619707,815717,803990,1019634,593679,425955,379583,61190,440773,975114,383172,260898,523
405,Chhattisgarh,Bilaspur,2663629,1351574,1312055,1596560,932474,664086,549632,188174,737806,1625484,655032,380114,2999
406,Chhattisgarh,Kabeerdham,822526,412058,410468,414167,248503,165664,187311,23868,211179,515971,198517,107854,184
407,Chhattisgarh,Rajnandgaon,1537133,762855,774278,1008379,561355,447024,313604,76528,390132,898915,404418,233068,732
408,Chhattisgarh,Durg,3343872,1682101,1661771,2303378,1284612,1018766,533448,349741,883189,1919832,898241,523656,2143
409,Chhattisgarh,Raipur,4063872,2048186,2015686,2629749,1493158,1136591,673499,395001,1068500,2454299,1038155,560184,11234
410,Chhattisgarh,Mahasamund,1032754,511967,520787,637963,364089,273874,274793,35774,310567,582544,272009,177826,375
411,Chhattisgarh,Dhamtari,799781,397897,401884,546833,303924,242909,168689,41792,210481,461125,213021,125429,206
412,Chhattisgarh,Uttar Bastar Kanker,748941,373338,375603,456042,258298,197744,169191,24878,194069,437598,197603,113450,290
413,Chhattisgarh,Bastar,1413199,698487,714712,650863,382335,268528,316425,54894,371319,864272,358157,189569,1201
414,Chhattisgarh,Narayanpur,139820,70104,69716,56621,33449,23172,26916,6179,33095,91338,33956,14367,159
415,Chhattisgarh,Dakshin Bastar Dantewada,533638,264142,269496,191237,116529,74708,106545,31304,137849,334987,140188,58170,293
416,Chhattisgarh,Bijapur,255230,128663,126567,86919,54076,32843,50449,7942,58391,167348,63802,23927,153
417,Madhya Pradesh,Sheopur,687861,361784,326077,328025,208201,119824,150146,26376,176522,449974,155063,82416,408
418,Madhya Pradesh,Morena,1965970,1068417,897553,1179685,747652,432033,319298,95288,414586,1254302,452484,257704,1480
419,Madhya Pradesh,Bhind,1703005,926843,776162,1094917,676513,418404,271211,88385,359596,1040736,399676,258588,4005
420,Madhya Pradesh,Gwalior,2032036,1090327,941709,1357210,803114,554096,172720,272172,444892,1218319,519728,291451,2538
421,Madhya Pradesh,Datia,786754,420157,366597,491445,303815,187630,160453,43401,203854,473097,195131,118186,340
422,Madhya Pradesh,Shivpuri,1726050,919795,806255,900846,573242,327604,367859,66759,434618,1106084,389652,227989,2325
423,Madhya Pradesh,Tikamgarh,1445166,760355,684811,747940,459353,288587,322772,60220,382992,898323,343824,201875,1144
424,Madhya Pradesh,Chhatarpur,1762375,936121,826254,943033,572010,371023,375869,95048,470917,1112636,394060,252417,3262
425,Madhya Pradesh,Panna,1016520,533480,483040,552559,332140,220419,256744,32179,288923,635347,235035,144827,1311
426,Madhya Pradesh,Sagar,2378458,1256257,1122201,1545719,908607,637112,448408,165507,613915,1470688,569166,335432,3172
427,Madhya Pradesh,Damoh,1264219,661873,602346,747715,445737,301978,303387,66514,369901,768929,312593,181403,1294
428,Madhya Pradesh,Satna,2228935,1157495,1071440,1371781,801051,570730,461831,114173,576004,1365647,535086,326049,2153
429,Madhya Pradesh,Rewa,2365106,1225100,1140006,1441757,845572,596185,523910,94489,618399,1460075,540235,362228,2568
430,Madhya Pradesh,Umaria,644758,330674,314084,356672,210907,145765,138100,29966,168066,403030,158140,82984,604
431,Madhya Pradesh,Neemuch,826067,422653,403414,508834,307889,200945,174235,67962,242197,476995,217403,131227,442
432,Madhya Pradesh,Mandsaur,1340411,682851,657560,834591,502898,331693,302287,81832,384119,781000,346861,211815,735
433,Madhya Pradesh,Ratlam,1455069,738241,716828,825880,485090,340790,266716,107151,373867,876905,363858,213560,746
434,Madhya Pradesh,Ujjain,1986864,1016289,970575,1240990,730817,510173,300765,188684,489449,1156749,508302,320502,1311
435,Madhya Pradesh,Shajapur,1512681,780520,732161,894612,543509,351103,312611,73997,386608,901161,369741,240768,1011
436,Madhya Pradesh,Dewas,1563715,805359,758356,925369,550716,374653,274995,101014,376009,943954,388648,230280,833
437,Madhya Pradesh,Dhar,2185793,1112725,1073068,1077338,638479,438859,412348,103364,515712,1377326,533243,273050,2174
438,Madhya Pradesh,Indore,3276697,1699627,1577070,2309130,1289631,1019499,200371,587947,788318,1877270,894464,493096,11867
439,Madhya Pradesh,Khargone (West Nimar),1873046,953121,919925,986234,575428,410806,383543,76620,460163,1166866,450248,254570,1362
440,Madhya Pradesh,Barwani,1385881,699340,686541,549926,313642,236284,250358,48912,299270,923665,302833,158594,789
441,Madhya Pradesh,Rajgarh,1545814,790212,755602,804245,488797,315448,331894,69823,401717,935230,363218,246447,919
442,Madhya Pradesh,Vidisha,1458875,769568,689307,862918,512344,350574,292579,83830,376409,919239,335690,203005,941
443,Madhya Pradesh,Bhopal,2371061,1236130,1134931,1660690,920314,740376,118893,581826,700719,1405814,625594,330291,9362
444,Madhya Pradesh,Sehore,1311332,683743,627589,780362,469208,311154,270427,59220,329647,817608,305605,187611,508
445,Madhya Pradesh,Raisen,1331597,700358,631239,820220,479093,341127,251272,74441,325713,832939,316319,181524,815
446,Madhya Pradesh,Betul,1575362,799236,776126,939769,529783,409986,318945,87704,406649,938819,392728,242592,1223
447,Madhya Pradesh,Harda,570465,294838,275627,352550,203807,148743,112714,31845,144559,347774,138882,83417,392
448,Madhya Pradesh,Hoshangabad,1241350,648725,592625,810644,469199,341445,209650,105746,315396,730768,318232,191501,849
449,Madhya Pradesh,Katni,1292042,662013,630029,790773,460583,330190,276151,72880,349031,778414,326582,185857,1189
450,Madhya Pradesh,Jabalpur,2463289,1277278,1186011,1756468,980307,776161,272284,352477,624761,1387369,679185,391903,4832
451,Madhya Pradesh,Narsimhapur,1091854,568810,523044,718785,413491,305294,230659,53059,283718,620415,289560,180831,1048
452,Madhya Pradesh,Dindori,704524,351913,352611,378714,222759,155955,218021,9774,227795,419531,181841,102522,630
453,Madhya Pradesh,Mandla,1054905,525272,529633,604962,348033,256929,279674,37258,316932,614794,278553,160510,1048
454,Madhya Pradesh,Chhindwara,2090922,1064468,1026454,1294198,731294,562904,413142,140802,553944,1232263,535316,321977,1366
455,Madhya Pradesh,Seoni,1379131,695879,683252,864194,485341,378853,335045,47542,382587,809922,363037,205237,935
456,Madhya Pradesh,Balaghat,1701698,842178,859520,1147623,626468,521155,400074,70793,470867,969773,453605,276799,1521
457,Madhya Pradesh,Guna,1241519,649362,592157,653980,400537,253443,212765,72320,285085,793150,285176,162104,1089
458,Madhya Pradesh,Ashoknagar,845071,443837,401234,469109,290304,178805,169606,37135,206741,535410,194772,114131,758
459,Madhya Pradesh,Shahdol,1066063,540021,526042,604194,348761,255433,233594,57846,291440,645619,269145,150655,644
460,Madhya Pradesh,Anuppur,749237,379114,370123,436595,254120,182475,0,0,207713,0,193520,0,950
461,Madhya Pradesh,Sidhi,1127033,575912,551121,600785,353030,247755,250953,25916,276869,721531,253685,150959,858
462,Madhya Pradesh,Singrauli,1178273,613637,564636,585054,359923,225131,228732,58593,287325,771725,267189,138276,1083
463,Madhya Pradesh,Jhabua,1025048,515023,510025,352081,214582,137499,211080,24713,235793,684200,220769,119681,398
464,Madhya Pradesh,Alirajpur,728999,362542,366457,209754,120905,88849,135866,14662,150528,488848,155328,84149,674
465,Madhya Pradesh,Khandwa (East Nimar),1310061,674329,635732,731615,432259,299356,265663,63425,329088,809091,313456,186928,586
466,Madhya Pradesh,Burhanpur,757847,388504,369343,408679,233073,175606,115979,62861,178840,469838,181605,106034,370
467,Gujarat,Kachchh,2092371,1096737,995634,1252319,739239,513080,488293,250982,739275,1278604,524052,286086,3629
468,Gujarat,Banas Kantha,3120506,1610379,1510127,1704923,1048402,656521,666773,137424,804197,1984701,738412,394793,2600
469,Gujarat,Patan,1343734,694397,649337,837913,494631,343282,301483,102655,404138,786357,341381,213465,2531
470,Gujarat,Mahesana,2035064,1056520,978544,1502645,847499,655146,476005,183738,659743,1119451,0,0,3603
471,Gujarat,Sabar Kantha,2428589,1244231,1184358,1578734,918625,660109,544024,121509,665533,1393131,630963,400905,3590
472,Gujarat,Gandhinagar,1391753,723864,667889,1030494,582686,447808,237624,195634,433258,769329,391862,224886,5676
473,Gujarat,Ahmadabad,7214225,3788051,3426174,5435760,3025463,2410297,353169,1845383,2198552,3952858,2043895,1198152,19320
474,Gujarat,Surendranagar,1756268,909917,846351,1093626,643221,450405,340788,159810,500598,1033435,439352,280582,2899
475,Gujarat,Rajkot,3804558,1974445,1830113,2725056,1514075,1210981,459474,721532,1181006,2080568,1052871,659576,11543
476,Gujarat,Jamnagar,2160119,1114192,1045927,1396534,795140,601394,347158,299167,646325,1220598,576319,358455,4747
477,Gujarat,Porbandar,585449,300209,285240,393678,221621,172057,96015,87557,183572,314886,163777,105638,1148
478,Gujarat,Junagadh,2743082,1404356,1338726,1842818,1046981,795837,489237,287506,776743,1527888,749156,461650,4388
479,Gujarat,Amreli,1514190,771049,743141,995459,558180,437279,313714,116899,430613,836343,389892,282409,5546
480,Gujarat,Bhavnagar,2880365,1490201,1390164,1887255,1087371,799884,387251,356826,744077,1708938,720241,445121,6065
481,Gujarat,Anand,2092745,1087224,1005521,1551253,874481,676772,413078,208909,621987,1134962,585093,366419,6271
482,Gujarat,Kheda,2299885,1185727,1114158,1660243,942480,717763,461479,160547,622026,1260660,628221,388646,22358
483,Gujarat,Panch Mahals,2390776,1226961,1163815,1440805,858054,582751,463363,104238,567601,1421859,599925,363391,5601
484,Gujarat,Dohad,2127086,1068651,1058435,1007171,599035,408136,323697,52807,376504,1402616,467115,252153,5202
485,Gujarat,Vadodara,4165626,2153736,2011890,2893080,1614087,1278993,547454,692971,1240425,2213474,1190041,733710,28401
486,Gujarat,Narmada,590297,301086,289211,370336,211767,158569,138121,22248,160369,336830,157910,93466,2091
487,Gujarat,Bharuch,1551019,805707,745312,1118276,623047,495229,300677,181319,481996,844298,442523,254728,9470
488,Gujarat,The Dangs,228291,113821,114470,140968,77314,63654,52102,7516,59618,146095,51821,30027,348
489,Gujarat,Navsari,1329672,678165,651507,1001909,539471,462438,267739,141417,409156,673014,390349,258957,7352
490,Gujarat,Valsad,1705678,887222,818456,1170657,655528,515129,262410,235981,498391,944532,485874,259906,15366
491,Gujarat,Surat,6081322,3402224,2679098,4571410,2687468,1883942,369840,1529998,1899838,3563443,1740746,723415,53718
492,Gujarat,Tapi,807022,402188,404834,490036,269007,221029,192272,26217,218489,422047,235019,144575,5381
493,Daman and Diu,Diu,52074,25642,26432,38058,20327,17731,9788,9062,18850,30475,13932,7599,68
494,Daman and Diu,Daman,191173,124659,66514,150348,104316,46032,10006,61073,71079,122589,52868,15428,288
495,Dadra and Nagar Haveli,Dadra and Nagar Haveli,343709,193760,149949,223230,142521,80709,48221,60562,108783,225103,87888,30346,372
496,Maharashtra,Nandurbar,1648295,833170,815125,906509,512099,394410,333440,71572,405012,1011352,390419,241534,4990
497,Maharashtra,Dhule,2050862,1054031,996831,1293916,723388,570528,382777,146013,528790,1167569,513908,350747,18638
498,Maharashtra,Jalgaon,4229917,2197365,2032552,2891882,1629223,1262659,796223,373565,1169788,2352671,1080237,763529,33480
499,Maharashtra,Buldana,2586258,1337560,1248698,1879874,1048892,830982,575405,152787,728192,1467457,641840,473071,3890
500,Maharashtra,Akola,1813906,932334,881572,1411281,758977,652304,308158,196077,504235,998769,483200,327932,4005
501,Maharashtra,Washim,1197160,620302,576858,869917,487703,382214,274925,55921,330846,682919,302425,210185,1631
502,Maharashtra,Amravati,2888445,1480768,1407677,2251875,1207104,1044771,508921,272894,781815,1540590,783549,553265,11041
503,Maharashtra,Wardha,1300774,668385,632389,1019458,552617,466841,268486,120218,388704,659540,370227,270107,900
504,Maharashtra,Nagpur,4653570,2384975,2268595,3673808,1959220,1714588,430844,877522,1308366,2460820,1361821,818467,12462
505,Maharashtra,Bhandara,1200334,605520,594814,899860,488709,411151,283843,72575,356418,626978,333120,232754,7482
506,Maharashtra,Gondiya,1322507,661554,660953,1004243,542837,461406,319702,66813,386515,704214,371908,244111,2274
507,Maharashtra,Gadchiroli,1072942,541328,531614,708365,395110,313255,293586,37254,330840,605217,289448,175518,2759
508,Maharashtra,Chandrapur,2204307,1123834,1080473,1578615,872565,706050,451324,233331,684655,1163802,629890,403719,6896
509,Maharashtra,Yavatmal,2772348,1419965,1352383,2022574,1115980,906594,629243,168889,798132,1549263,733258,483813,6014
510,Maharashtra,Nanded,3361292,1730075,1631217,2189425,1255222,934203,591119,230563,821682,2008314,809135,535827,8016
511,Maharashtra,Hingoli,1177345,606294,571051,790743,450551,340192,242456,41913,284369,692117,281905,201828,1495
512,Maharashtra,Parbhani,1836086,942870,893216,1157814,666291,491523,293480,133759,427239,1078349,436486,313455,7796
513,Maharashtra,Jalna,1959046,1011473,947573,1195523,699428,496095,404746,98084,502830,1150104,454836,341479,12627
514,Maharashtra,Aurangabad,3701282,1924469,1776813,2503837,1430936,1072901,551789,427343,979132,2211996,909771,571932,7583
515,Maharashtra,Nashik,6107187,3157186,2950001,4345366,2397538,1947828,904661,764271,1668932,3580633,1567252,948469,10833
516,Maharashtra,Thane,11060148,5865078,5195070,8227161,4591396,3635765,713994,2904157,3618151,6184519,3241888,1579921,53820
517,Maharashtra,Mumbai Suburban,9356962,5031323,4325639,7575485,4223029,3352456,0,3078829,3078829,4936360,2812001,1575566,33035
518,Maharashtra,Mumbai,3085411,1684608,1400803,2509022,1410680,1098342,0,1107321,1107321,1553005,933586,583243,15577
519,Maharashtra,Raigarh,2634200,1344345,1289855,1939994,1059692,880302,581868,377160,959028,1414154,748339,462741,8966
520,Maharashtra,Pune,9429408,4924105,4505303,7171723,3940210,3231513,1165718,2056739,3222457,5184734,2624165,1586132,34377
521,Maharashtra,Ahmadnagar,4543159,2342825,2200334,3151890,1773355,1378535,1041393,282011,1323404,2496560,1166245,865139,15215
522,Maharashtra,Bid,2585049,1349106,1235943,1718507,987185,731322,563114,135457,698571,1473882,614615,494436,2116
523,Maharashtra,Latur,2454196,1273140,1181056,1650672,932432,718240,428616,157016,585632,1406364,584243,453229,10360
524,Maharashtra,Osmanabad,1657576,861535,796041,1137810,644304,493506,367158,77832,444990,917343,393539,343021,3673
525,Maharashtra,Solapur,4317756,2227852,2089904,2910676,1651266,1259410,779929,376302,1156231,2402794,1089900,809935,15127
526,Maharashtra,Satara,3003741,1510842,1492899,2225694,1201034,1024660,774522,200949,975471,1517324,800492,671702,14223
527,Maharashtra,Ratnagiri,1615069,761121,853948,1199392,619012,580380,538538,100824,639362,777431,438905,396967,1766
528,Maharashtra,Sindhudurg,849651,417332,432319,666067,348289,317778,295847,44989,340836,382024,242296,222963,2368
529,Maharashtra,Kolhapur,3876001,1980658,1895343,2825845,1559760,1266085,796496,382818,1179314,1972486,1084858,801590,17067
530,Maharashtra,Sangli,2822143,1435728,1386415,2049467,1121550,927917,626872,226801,853673,1450907,752303,603739,15194
531,Telangana,Adilabad,2741239,1369597,1371642,1483347,856350,626997,597466,220248,817714,1536378,704551,422522,77788
532,Telangana,Nizamabad,2551335,1250641,1300694,1389810,790214,599596,565165,155133,720298,1399773,676401,437573,37588
533,Telangana,Karimnagar,3776269,1880800,1895469,2206829,1257238,949591,877236,288044,1165280,1940234,1031735,728494,75806
534,Telangana,Medak,3033288,1523030,1510258,1637137,953406,683731,593653,195479,789132,1735769,779738,509368,8413
535,Telangana,Hyderabad,3943323,2018575,1924748,2892155,1542688,1349467,0,1066289,1066289,2249130,1068243,542669,83281
536,Telangana,Rangareddy,5296741,2701008,2595733,3538028,1948784,1589244,432098,1129224,1561322,2966988,1455864,738037,135852
537,Telangana,Mahbubnagar,4053028,2050386,2002642,1940646,1158386,782260,848963,161052,1010015,2360874,1027525,637430,27199
538,Telangana,Nalgonda,3488809,1759772,1729037,2001019,1160757,840262,833504,197433,1030937,1932349,897137,651748,7575
539,Telangana,Warangal,3512576,1759281,1753295,2065023,1179790,885233,758738,288249,1046987,1891954,941452,664872,14298
540,Telangana,Khammam,2797370,1390988,1406382,1630234,901640,728594,669262,201363,870625,1530602,774583,477955,14230
541,Andhra Pradesh,Srikakulam,2703114,1341738,1361376,1495381,857824,637557,752752,149684,902436,1423119,747385,528736,3874
542,Andhra Pradesh,Vizianagaram,2344474,1161477,1182997,1238388,707503,530885,592458,157056,749514,1206366,666394,451469,20245
543,Andhra Pradesh,Visakhapatnam,4290589,2138910,2151679,2568249,1422878,1145371,718847,660493,1379340,2274553,1245627,716066,54343
544,Andhra Pradesh,East Godavari,5154296,2569688,2584608,3288577,1716933,1571644,1199479,406362,1605841,2724328,1478954,948122,2892
545,Andhra Pradesh,West Godavari,3936966,1964918,1972048,2652389,1379223,1273166,1007255,248373,1255628,2051513,1127764,755533,2156
546,Andhra Pradesh,Krishna,4517398,2267375,2250023,3009718,1598959,1410759,909292,567042,1476334,2340943,1284630,833959,57866
547,Andhra Pradesh,Guntur,4887813,2440521,2447292,2960441,1634726,1325715,1069877,513113,1582990,2583462,1371811,928462,4078
548,Andhra Pradesh,Prakasam,3397448,1714764,1682684,1904435,1107686,796749,873486,214089,1087575,1832695,917391,641707,5655
549,Andhra Pradesh,Sri Potti Sriramulu Nellore,2963557,1492974,1470583,1832189,1011922,820267,689137,264376,953513,1574713,840448,544022,4374
550,Andhra Pradesh,Y.S.R.,2882469,1451777,1430692,1716766,994699,722067,590589,293504,884093,1553667,793583,530412,4807
551,Andhra Pradesh,Kurnool,4053463,2039227,2014236,2127161,1246369,880792,783853,306982,1090835,2368684,1053618,609027,22134
552,Andhra Pradesh,Anantapur,4081148,2064495,2016653,2310960,1338474,972486,902997,341431,1244428,2189396,1104565,739612,47575
553,Andhra Pradesh,Chittoor,4174064,2090204,2083860,2667878,1484794,1183084,0,395900,0,2148179,1159053,807430,59402
554,Karnataka,Belgaum,4779661,2423063,2356598,3052032,1725548,1326484,962777,356198,1318975,2669348,1251116,857143,2054
555,Karnataka,Bagalkot,1889752,950111,939641,1113412,641388,472024,324799,165858,490657,1123443,465706,299774,829
556,Karnataka,Bijapur,2177331,1111022,1066309,1248268,730566,517702,396449,131041,527490,1295274,527085,353549,1423
557,Karnataka,Bidar,1703300,870665,832635,1042673,597198,445475,287134,102269,389403,1018195,397120,287271,714
558,Karnataka,Raichur,1928812,964511,964301,979769,577213,402556,330446,125402,455848,1196670,465173,265810,1159
559,Karnataka,Koppal,1389920,699926,689994,809085,468785,340300,272968,64681,337649,855430,330393,202984,1113
560,Karnataka,Gadag,1064570,537147,527423,700177,397178,302999,180066,111906,291972,601578,279069,183409,514
561,Karnataka,Dharwad,0,0,909817,1301664,711776,589888,199707,283397,483104,1017935,0,322577,823
562,Karnataka,Uttara Kannada,1437169,726256,710913,1081906,582099,499807,334281,140511,474792,742281,412649,281542,697
563,Karnataka,Haveri,1597668,819128,778540,1085443,603793,481650,315076,98488,413564,904453,426094,266586,535
564,Karnataka,Bellary,2452595,1236954,1215641,1421621,813440,608181,371604,251876,623480,1487013,617276,346905,1401
565,Karnataka,Chitradurga,1659456,840843,818613,1087392,607188,480204,349704,97644,447348,891230,460057,306412,1757
566,Karnataka,Davanagere,1945497,986400,959097,1308540,720637,587903,354680,176011,530691,1068518,538551,336173,2255
567,Karnataka,Shimoga,1752753,877415,875338,1263016,674938,588078,352444,201662,554106,913150,513297,325542,764
568,Karnataka,Udupi,1177361,562131,615230,0,0,460725,269817,115572,385389,559565,340903,276234,659
569,Karnataka,Chikmagalur,1137961,566622,571339,818345,438257,380088,311660,80766,392426,564994,341380,230864,723
570,Karnataka,Tumkur,2678980,1350594,1328386,1813391,1006024,807367,685443,204799,890242,1351461,760936,564196,2387
571,Karnataka,Bangalore,9621551,5022661,4598890,7512276,4078041,3434235,300576,2967384,3267960,5275666,2909575,1424195,12115
572,Karnataka,Mandya,1805769,905085,900684,1149649,638668,510981,458867,103435,562302,902307,527236,375100,1126
573,Karnataka,Hassan,1776421,883667,892754,1225256,668836,556420,496103,132878,628981,877340,522039,375918,1124
574,Karnataka,Dakshina Kannada,2089649,1034714,1054935,1666323,864019,802304,332919,317373,650292,1072417,608450,407902,880
575,Karnataka,Kodagu,554519,274608,279911,412877,215302,197575,181182,31792,212974,276918,163360,113919,322
576,Karnataka,Mysore,3001127,1511600,1489527,1962180,1063766,898414,540596,380386,920982,1580116,865220,553705,2086
577,Karnataka,Chamarajanagar,1020791,512231,508560,565279,312957,252322,262680,57200,319880,519046,294903,206003,839
578,Karnataka,Gulbarga,2566326,1301755,1264571,1427368,828359,599009,400704,199303,600007,1570719,604665,388935,2007
579,Karnataka,Yadgir,1174271,590329,583942,510003,306751,203252,207787,55208,262995,738451,267222,168186,412
580,Karnataka,Kolar,1536401,776396,760005,1016219,564110,452109,326567,151042,477609,841499,419380,274240,1282
581,Karnataka,Chikkaballapura,1255104,636437,618667,783222,442158,341064,315649,94053,409702,666451,350299,236864,1490
582,Karnataka,Bangalore Rural,990923,509172,481751,688749,385311,303438,231052,95410,326462,535765,278153,176083,922
583,Karnataka,Ramanagara,1082636,548008,534628,674758,378461,296297,266950,84834,351784,559082,297330,224785,1439
584,Goa,North Goa,818008,416677,401331,663060,351738,311322,115859,209230,325089,380926,260533,175035,1514
585,Goa,South Goa,640537,322463,318074,502427,264085,238342,88620,162873,251493,314480,194872,130605,580
586,Lakshadweep,Lakshadweep,64473,33123,31350,52553,28023,24530,5289,15953,21242,33877,19244,11237,115
587,Kerala,Kasaragod,1307375,628613,678762,1037492,516476,521016,251641,166164,417805,688763,369883,246975,1754
588,Kerala,Kannur,2523003,1181446,1341557,2138434,1012956,1125478,306288,566191,872479,1187177,741984,588081,5761
589,Kerala,Wayanad,817420,401684,415736,645585,328136,317449,266183,11805,277988,412806,246590,157326,698
590,Kerala,Kozhikode,3086293,1470942,1615351,2615443,1266939,1348504,323793,666543,990336,1487644,909581,686109,2959
591,Kerala,Malappuram,4112920,1960328,2152592,3311315,1597404,1713911,634543,522586,1157129,2406005,1041361,662311,3243
592,Kerala,Palakkad,2809934,1359478,1450456,2239492,1122600,1116892,665899,228442,894341,1395222,802611,608966,3135
593,Kerala,Thrissur,3121200,1480763,1640437,2678548,1282261,1396287,336748,715119,1051867,1394214,931841,792182,2963
594,Kerala,Ernakulam,3282388,1619557,1662831,2855676,1425723,1429953,369694,804997,1174691,1396968,1024720,858010,2690
595,Kerala,Idukki,1108974,552808,556166,923010,471881,451129,391610,20823,412433,494456,352163,261471,884
596,Kerala,Kottayam,1974551,968289,1006262,1749798,861592,888206,481967,196194,678161,811653,596302,565048,1548
597,Kerala,Alappuzha,2127789,1013142,1114647,1852797,890552,962245,331419,392117,723536,891512,648522,585591,2164
598,Kerala,Pathanamthitta,1197412,561716,635696,1062553,499181,563372,414992,57848,472840,479207,346161,370887,1157
599,Kerala,Kollam,2635375,1246968,1388407,2240273,1074345,1165928,523715,401415,925130,1177359,795245,660965,1806
600,Kerala,Thiruvananthapuram,3301427,1581678,1719749,2785408,1354857,1430551,559293,609824,1169117,1488441,989238,820024,3724
601,Tamil Nadu,Thiruvallur,3728104,1876062,1852042,2791721,1495711,1296010,387237,732196,1119433,1925296,1154775,643614,4419
602,Tamil Nadu,Chennai,4646732,2335844,2310888,3776276,1968079,1808197,0,1314125,1314125,2271657,1468902,899279,6894
603,Tamil Nadu,Kancheepuram,3998252,2012958,1985294,3013382,1611461,1401921,438799,774705,1213504,2076492,1200284,715895,5581
604,Tamil Nadu,Vellore,3936331,1961688,1974643,2773928,1504355,1269573,653499,486801,1140300,2096113,1116437,720713,3068
605,Tamil Nadu,Tiruvannamalai,2464875,1235889,1228986,1626813,909803,717010,563102,147061,710163,1301347,683904,477668,1956
606,Tamil Nadu,Viluppuram,3458873,1740819,1718054,2195776,1234479,961297,808042,159272,967314,1881463,949892,624042,3476
607,Tamil Nadu,Salem,3482056,1781571,1700485,2285562,1285107,1000455,572813,597539,1170352,1737345,1029479,713294,1938
608,Tamil Nadu,Namakkal,1726601,869280,857321,1176131,653312,522819,370357,257127,627484,817905,510413,397064,1219
609,Tamil Nadu,Erode,2251744,1129868,1121876,1492662,828300,664362,411286,432398,843684,1006543,701326,542295,1580
610,Tamil Nadu,The Nilgiris,735394,360143,375251,569647,299447,270200,112126,151979,264105,352516,231451,150804,623
611,Tamil Nadu,Dindigul,2159775,1080938,1078837,1481834,816180,665654,443818,269724,713542,1065734,647806,443528,2707
612,Tamil Nadu,Karur,1064493,528184,536309,727044,401726,325318,212241,152420,364661,501585,320645,241843,420
613,Tamil Nadu,Tiruchirappalli,2722290,1352284,1370006,2038981,1087765,951216,452707,423020,875727,1346661,797258,575960,2411
614,Tamil Nadu,Perambalur,565223,282157,283066,375823,208011,167812,155413,33179,188592,291371,158218,115151,483
615,Tamil Nadu,Ariyalur,754894,374703,380191,480604,269582,211022,223955,30322,254277,380484,216103,157771,536
616,Tamil Nadu,Cuddalore,2605914,1311697,1294217,1815281,1000322,814959,497429,260780,758209,1364411,764669,473617,3217
617,Tamil Nadu,Nagapattinam,1616450,798127,818323,1213008,640916,572092,399016,118724,517740,828444,463326,323706,974
618,Tamil Nadu,Thiruvarur,1264277,626693,637584,946471,503085,443386,321331,86848,408179,627880,377118,257116,2163
619,Tamil Nadu,Thanjavur,2405890,1182416,1223474,1790998,944264,846734,479070,274302,753372,1193095,712017,499235,1543
620,Tamil Nadu,Pudukkottai,1618345,803188,815157,1110545,608776,501769,399712,104229,503941,835853,470428,311175,889
621,Tamil Nadu,Sivaganga,1339101,668672,670429,959744,526304,433440,309224,143193,452417,666218,391356,280462,1065
622,Tamil Nadu,Madurai,3038252,1526475,1511777,2273430,1223810,1049620,417718,592723,1010441,1528178,0,0,2532
623,Tamil Nadu,Theni,1245899,625683,620216,870080,479403,390677,189328,221295,410623,618923,373564,252267,1145
624,Tamil Nadu,Virudhunagar,1942288,967709,974579,1398788,760375,638413,363782,370942,734724,987538,575006,378174,1570
625,Tamil Nadu,Ramanathapuram,1353445,682658,670787,978946,536487,442459,290478,126761,417239,708322,389764,0,0
626,Tamil Nadu,Thoothukkudi,1750176,865021,885155,1349697,703106,646591,336078,300661,636739,887717,499377,361374,1708
627,Tamil Nadu,Tirunelveli,3077233,1520912,1556321,2273457,1210710,1062747,547962,516705,1064667,1554277,876129,644563,2264
628,Tamil Nadu,Kanniyakumari,1870374,926345,944029,1548738,780541,768197,104253,493788,598041,887052,556548,425849,925
629,Tamil Nadu,Dharmapuri,1506843,774303,732540,917709,527599,390110,396819,91107,487926,804186,434328,267536,793
630,Tamil Nadu,Krishnagiri,1879809,960232,919577,1187958,667062,520896,437988,142552,580540,1034474,533183,311238,914
631,Tamil Nadu,Coimbatore,3458045,1729297,1728748,2635907,1394790,1241117,284795,884957,1169752,1579517,1117221,757738,3569
632,Tamil Nadu,Tiruppur,2479052,1246159,1232893,1760566,959623,800943,356886,538022,894908,1177987,794639,504674,1752
633,Pondicherry,Yanam,55626,27301,28325,39274,19919,19355,0,15519,15519,31973,15235,8402,16
634,Pondicherry,Pondicherry,950289,468258,482031,726649,380946,345703,87296,203741,291037,473705,299746,176204,634
635,Pondicherry,Mahe,41816,19143,22673,36470,16610,19860,0,12110,12110,19760,12543,9428,85
636,Pondicherry,Karaikal,200222,97809,102413,154916,79903,75013,35618,33715,69333,0,60089,0,366
637,Andaman and Nicobar Islands,Nicobars,36842,20727,16115,25332,15397,9935,15958,0,15958,18786,12088,5922,46
638,Andaman and Nicobar Islands,North  and Middle Andaman,105597,54861,50736,78683,43186,35497,39091,1094,40185,57350,30741,17464,42
639,Andaman and Nicobar Islands,South Andaman,238142,127283,110859,190266,105794,84472,34901,50631,85532,128402,76332,33128,280
